Introduction
##############################
#                           E#
#                            #
#                            #
#            # #             #
#            # #             #
#         #### ####          #
#                            #
#             @              #
#                            #
#         #### ####          #
#         #       #          #
#         #### ####          #
#                            #
#                            #
#                            #
#  ##     # # # # #     ##   #
#  #       # # # #       #   #
#                            #
#                            #
#                            #
#             #              #
###### ####### ####### #######
#                            #
# ############ ############  #
# #          # #          #  #
### ######## # # ######## ####
#P                           #
##############################

