Introduction
##############################
#                           E#
#                            #
#                            #
#            # #             #
#            # #             #
#         #### ####          #
#                            #
#                            #
#                            #
#         #### ####          #
#         #       #          #
#         #### ####          #
#                            #
#             @              #
#                            #
#         #### ####          #
#                            #
#         #### ####          #
#                            #
#                            #
#                            #
###### ####### ######## ######
#                            #
# ############ ############# #
# #          # #           # #
### ######## # # ######### ###
#P                           #
##############################
