Introduction
#############################
#                          E#
#                           #
#                           #
#            # #            #
#            # #            #
#         #### ####         #
#                           #
#                           #
#                           #
#         #### ####         #
#         #       #         #
#         #### ####         #
#                           #
#             @             #
#                           #
#         #### ####         #
#                           #
#         #### ####         #
#                           #
#                           #
#                           #
###### ####### ######## #####
#                           #
# ############ ############ #
# #          # #          # #
### ######## # # ######## ###
#P                          #
#############################
