Warming Up
#############################
#                           #
###         #   #         ###
###        ###E###        ###
###         #   #         ###
#                           #
# ##     # # # # # #     ## #
# #                       # #
#  #                     #  #
# #                       # #
#  #                     #  #
# #   #               #   # #
#  # ###             ### #  #
# #   #               #   # #
#  #                     #  #
# #                       # #
#  #                     #  #
# #                       # #
#  #                     #  #
# #                       # #
#  #                     #  #
# #                       # #
#  #### # # ## ## # # ####  #
# #                       # #
# # ########## ########## # #
#@#          # #          # #
### ######## # # ######## ###
#             P             #
#############################

