Introduction
##############################
#                            #
#                            #
#                            #
#            # #             #
#            # #             #
#         #### ####          #
#                            #
#                            #
#                            #
#         #### ####          #
#         #       #          #
#         #### ####          #
#                            #
#             @              #
#                            #
#         #### ####          #
#                            #
#         #### ####          #
#                            #
#                            #
#                            #
###### ################ ######
#                            #
# ############ ############# #
# #                        # #
# # ######## # # ######### # #
#P                          E#
##############################
