Introduction
#############################
#             E             #
#                           #
#                           #
#            # #            #
#            # #            #
#          ### ###          #
#                           #
#                           #
#                           #
#          ##   ##          #
#         #   @   #         #
#         ###   ###         #
#                           #
#                           #
#                           #
#         #### ####         #
#        #         #        #
#         ###   ###         #
#                           #
#                           #
#                           #
###### ##### ### ###### #####
#                           #
# ############ ############ #
# #          # #          # #
### ######## # # ######## ###
#             P             #
#############################

