Introduction
#############################
#                           #
###                       ###
###         ## ##         ###
###          # #          ###
#                           #
#        # # #E# # #        #
#     #               #     #
#    ###             ###    #
#     #               #     #
#          ### ###          #
#        ##       ##        #
#       #  ### ###  #       #
#       #           #       #
#                           #
#                           #
#         ### # ###         #
#   ##       # #       ##   #
#  ##                   ##  #
# ##         # #         ## #
# #          # #          # #
#                           #
# ############ ############ #
# #                         #
# # ########## ########## # #
#@#          # #          # #
### ######## # # ######## ###
#             P             #
#############################

