Twisted
###################################
#              # E #              #
#              #   #              #
#               # #               #
#                                 #
#                                 #
#                                 #
#                                 #
#                                 #
#        ##             ##        #
#         #             #         #
#                                 #
#                                 #
#   ###       ### ###       ###   #
#           #  #   #  #           #
#  ## # # # ##       ## # # # ##  #
# ## # # # # ## # # ## # # # # ## #
#                #                #
# ###         # # # #         ### #
#    ##                     ##    #
# ##  #######  ## ##  #######  ## #
# # #       #  # @ #  #       # # #
# #  ### ## ##### ##### ## ###  # #
####    # # #   # #   # # #    ####
#   #     #  #  ###  #  #     #   #
# # #   ##  # ##   ## #  ##   # # #
# #    ##  ## ### ### ##  ##    # #
# ### ##  ##  #     #  ##  ## ### #
#    ##                     ##    #
# ##  # #####  ## ##  ##### #  ## #
# # #   # #   #  #  #   # #   # # #
#   ### #    ###   ###    # ###   #
#####     ###   # #   ###     #####
#                P                #
###################################

