Looks Familiar?
#############################
#                          E#
#                           #
#                           #
#            # #            #
#            # #            #
#         #### ####         #
#                           #
#             @             #
#                           #
#         #### ####         #
#         #       #         #
#         #### ####         #
#                           #
#                           #
#                           #
#  ##     # # # # #     ##  #
#  #       # # # #       #  #
#                           #
#                           #
#                           #
#             #             #
###### ####### ####### ######
#                           #
# ############ ###########  #
# #          # #         #  #
### ######## # # ####### ####
#P                          #
#############################

