Weirdo
#############################################
#                    P#E                    #
#                # #     # #                #
#### ### ### ###  ## ### ##  ### ### ### ####
#                    # #                    #
#                                           #
## ###             ### ###             ### ##
#    #             # # # #             #    #
#                                           #
##                                         ##
# #                                       # #
#  #                                     #  #
#  #                                     #  #
#  #                                     #  #
#  ### ##                           ## ###  #
#    #  #                           #  #    #
#    #  #                           #  #    #
#    ##                               ##    #
#                                           #
#                                           #
#                                           #
#                                           #
#                                           #
#                                           #
#                                           #
#                                           #
#                                           #
#                                           #
#                                           #
#                                           #
#                                           #
#                                           #
#                                           #
#                                           #
#                                           #
#                                           #
#                                           #
#                                           #
#                                           #
#                                           #
#                                           #
#                                           #
#                     #                     #
#                     @                     #
#############################################

